...................#
12................A#
#########---.....--#
...................#
A..A........########
######------########
....................
.......C..C..C...C..
...-------##########
..........#.........
........---........X
................####
...............#####
...........C..######
#####.....##########
