####################
#.################.#
#..##############..#
#...############...#
#....##########....#
##....########....##
###....######....###
####....####....####
#####....##....#####
####............####
###..............###
##................##
#..................#
#12..........B....X#
####################
