####################
######..............
######..............
#.......A..........X
.......----....#####
C.C.C...............
-----.....-.........
....A.......-...---.
...---..............
##.......C..........
##......---.........
....................
..............---...
21..................
####################
