#12#################
#......###....###..#
#.......#......#...#
#..................#
#..................#
#...........D......#
###############....#
################...#
##############.....#
#############......#
....#####.........##
X................###
#...............####
##.............#####
####################
